11111111111111111111111111111111
11000000000000000000000000000011
11000000000000000000000000000011
11000000000000000000000000000011
11000000000000000000000000000011
11000000000000000000000000000011
11000000000000000000000000000011
11000000004000003000004000000011
11000000000000000000000000000011
11220002222222222222222220002211
11000000000000000000000000000011
11000000000000000000000000000011
11000000000000000000000000000011
11000000000000000000000000000011
11220002222222222222222220002211
11000000000000000000000000000011
11000000000000000000000000000011
11000000000000000000000000000011
11000000000000000000000000000011
11220002222222222222222220002211
11000000000000000000000000000011
11000000000000000000000000000011
11005000000000000000000000000011
11000000000000000000000000000011
11111111111111111111111111111111
