11111111100011111111000111111111
11000000000000000000000000000011
11000000004000000000400000000011
11000000000000000000000000000011
11000222222220000002222222200011
11000200000000000000000000200011
11000200000000000000000000200011
11000204000000000000000400200011
11000200000000000000000000200011
11000222222222000022222222200011
11000200000000000000000000200011
11000200000000000000000000200011
11000200000000000000000000200011
11000200000000000000000000200011
11000222222222200222222222200011
11000000000000000000000000000011
11000000000000000000000000000011
11000000000000000000000000000011
11000000000000000000000000000011
11222220022200000000222002222211
11000000000000000000000000000011
11000000000000000000000000000011
11005000000000000000000000000011
11000000000000000000000000000011
11111111100011111111000111111111
