11111111111111111111111111111111
11000000000000000000000000000011
11000000000000000000000000000011
11000000002000000000000000000011
11000000000000000000000000000011
11000000000000000000000000000011
11000000000000000000000000000011
11000000000000000000000000000011
11000000000000000000000000000011
11110001111111111111111110001111
11000000000000000000000000000011
11000000000000000000000000000011
11000000000000000000000000000011
11000000000000000000000000000011
11110001111111111111111110001111
11000000000000000000000000000011
11000000000000000000000000000011
11000000000000000000000000000011
11000000000000000000000000000011
11110001111111111111111110001111
11000000000000000000000000000011
11000000000000000000000000000011
11000004000000000000000000000011
11000000000000000000000000000011
11111111111111111111111111111111
