11111111100011111111000111111111
11000000000000000000000000000011
11000000003000000000300000000011
11000000000000000000000000000011
11000122222200000000222222100011
11000100000000000000000000100011
11000100000000000000000000100011
11000104000000000000000400100011
11000100000000000000000000100011
11000122222220000002222222100011
11000100000000000000000000100011
11000100000000000000000000100011
11000100000000000000000000100011
11000100000000000000000000100011
11000122222222000222222222100011
11000000000000000000000000000011
11000000000000000000000000000011
11000000000000000000000000000011
11000000000000000000000000000011
11222220002200000000220002222211
11000000000000000000000000000011
11000000000000000000000000000011
11005000000000000000000000000011
11000000000000000000000000000011
11111111100011111111000111111111
