11111111111111111111111111111111
11000000000000000000000000000011
11000000000004000400000000000011
11000000000000000000000000000011
11000000000002222220000000000011
11000000000000000000000000000011
11000000000000000000000000000011
11000000000040000040000000000011
11000000000000000000000000000011
11000000002222200222220000000011
11000000000000000000000000000011
11000000000000000000000000000011
11000000000000000000000000000011
11000000000000000000000000000011
11000002222222222222222220000011
11000000000000000000000000000011
11000000000000000000000000000011
11000000000000000000000000000011
11000000000000000000000000000011
11002222222002222220022222220011
11000000000000000000000000000011
11000000000000000000000000000011
11005000000000000000000000000011
11000000000000000000000000000011
11111111111111111111111111111111
